11111111111111111111111111111111111111111111111111111111111111111111111111111111
1x000000000000000000000000000000000000000000000000000000000000000000000000000001
10000000000000000000000000000000000000000000000000000000000000000000000000000051
10000000000000000000000000000000000000000000000000000000000000000000000000011111
1000000000000000000000000000000000000000000000000000000000000000000000000x011111
10000000000000000000000000000000000000000000000000000000000000000000000001111111
10000000000000000000000000000000000000000000000000000000000000000000000001111111
10000000000000000000000000000000000000000000000000018888888810000000000111111111
10000000000000000000000000000x00000000000000000000018888888811000000000111111111
10000000000000000000000000001110000000000000000000018888888811100000011111111111
10000000000000000000000000001110000000000000000000018888888811110000011111111111
100000000000000000000000000111110000000000000000000188888888111110x1111111111111
10000000000000000000000000011111000000000000000000018888888810000001111111111111
11000000000000000000000000111111100000000000000000011111111110000111111111111111
11100000000000000000000000111111100000000000000000000000000000000111111111111111
11110000000000000000000001111111110000000000000000000000000000011111111111111111
11111000000000000000000001111111110000000000000000000000000000011111111111111111
11111100000000000000000011111111111000000000000000000000000001111111111111111111
11111110000000000000000011111111111x00000000000000000000000001111111111111111111
11111111000000000000000111111111111100000000000000000000000111111111111111111111
11111111100000x0000000011111111111110000x0000000x000000000x111111111111111111111
11111111111111111114441111111111111111333333333333311222211111111111111111111111
2 13
Hi there! You must to walk slower to follow these instruction.
I think you don't scare of these spike.
So high!
Wait! IS that ice?
Wee..e..~~e
The red square is lava, . . enter to never see your mom.
phew...w~ I hate this room -.- .
would you like to swim? The light blue square is water!
Good bye!see ya in your dream.