11111111111111111111111111111111111111111111111111111111111111111111111111111111
1x000000000000000000000000000000000000000000000000000000000000000000000000000001
11110000000000000000000000000000000000000000000000000000000000000000000000000001
11111000000000000000000000000000000000000000000000000000000000000000000000000001
11111100000000000000000000000060000000000000000000000000000000000000000000000001
11111110000990999000990990900010000000000000000000000000000000000000000000000001
11111111000000000000000000000000000000000000000000000000000000000000000000000001
11111111100000000000000000000000000000000000000000000000000000000000000000000001
11111111110000000000000000000000000000000000000000000000000000000000000000000001
11111111111000000000000000000000000000000000000000000000000000000000000000000001
11111111111100000000000000000000000000000000x000000000000000000000x0000000000001
11111111111119999999999999999999999999999991333333333333333330001111100000000001
11111111111112222222222222222222222222222221007000000000000014441000110000000001
10000000000012222222222222222222222222222221000000000000000011111000011000000001
10000000000011111111111111111111111111111111000000000000000000000000001100000001
10000000000000000000000000000000000000000000000000000000000000000000000110000001
10000000000000000000000000000000000000019111111111119100000000000000000011000001
10000000000000000000000000000000000000118888888888888110000000000000000001100001
10000000000000000000000000000000000001118888888888888111100000000000000000110001
10000000000000000000000000000000000011118868888888888111111000000000000000011001
15000000000000000000000000000000000111114111444441114111111100000000000000000001
11111111111111111111111111111111111111111111111111111111111111111111111111111111
2 2
can you eat the nearest heart there?
We..e..e
"whoose" that was close
