11111111111111111111111111111111111111111111111111111111111111111111111111111111
10000000000000000000000000000000000000000000000000000000000000000000000000000001
10000000000000000000000000000000000000000000000000000000000000000000000000000001
10000000000000000000000000000000000000000000000000000000000000000000000000000001
10000000000000000000000000000000000000000000000000000000000000000000000000000001
10000000000000000000000000000000000000000000000000000000000000000000000000000001
10000000000000000000000000000000000000000000000000000000000000000000000000000001
10000000000000000000000000000000000000000000000000000000000000000000000000000001
10000000000000000000000000000000000000000000000000000000000000000000000000000001
10000000000000000000000000000000000000000000000000000000000000000000000000000001
10000000000000000000000000000000000000000000000000000000000000000000000000000001
10000000000000000000000000000000000000000000000000000000000000000000000000000001
10000000000000000000000000000000000000000000000000000000000000000000000000000001
10000000000000000000000000000000000000000000000000000600700000000000000000000001
1x000000000000000000000000000000000000000000000000000900900000000000000000000001
110000000000000000000000000000000000000000000000009900000000000000000000000000x1
12100000000000000000000000000000000000000000000990000000000000000000000000070001
1221000000000000000000000000000000000000x000990000000000000000000000000000000001
12221000000000400000040000000400000000400000000040000000000440000004400000000451
12222133333333333333333333333333333333333333333333333333333333333333333333333331
11111111111111111111111111111111111111111111111111111111111111111111111111111111
00000000000000000000000000000000000000000000000000000000000000000000000000000000
2 15
ICE and Spike? seriously??
I think another way is good for me.
poo yah!