11111111111111111111111111111111111111111111111111111111111111111111111111111111
10x00000000000000000000000000000000000000000000000000000000000000000000000000001
11110000000000000000000000000000000000000000000000000000000000000000000000000001
10000000000000000000000000000000000000000000000000000000000000000000000000000001
10000000000000000000000000000000000000000000000000000000000000000000000000000001
10000000000000000000000000000000000000000000000000000000000000000000000000000001
10000191919191919191919191919191919191910000000000000000000000000000000000000001
10000000000000000000000000000000000000000000000x00000000000000000000000000000001
10000000000000000000000000000000000000009990999099909990999099909990999999990991
10333333333333333333333333333333333333332222222222222222222222222222222222222201
10000000000000000000000000000000000000000000000000000000000000000000000000000001
10000000000000000000000000000000000000000000000000000000000000000000000000000001
10000000000000000000000000000000000000000000000000000000000000000000000000000001
10000000000000000000000000000000000000000000000000000000000000000000000000000001
10000000000000000000000000000000000000000000000000000000000000000000000000000001
10000000000000000000000000000000000000000000000000000000000000000000000000000001
10000000000000000000000000000000000000000000006006000700700000000000000000005001
10000099000999900999900099990000999900099990009999000999900099990009999000999901
10000000000000000000000000000000000000000000000000000000000000000000000000000001
10000000000000000000000000000000000000000000000000000000000000000000000000000001
14444444444444444444444444444444444444444444444444444444444444444444444444444441
11111111111111111111111111111111111111111111111111111111111111111111111111111111
2 2
which way do you want to move? Ice or LAVAA?
I think you choose the right way!