11111111111111111111111111111111111111111111111111111111111111111111111111111111
10000000000000000000000000000000000000000000000000000000000000000000000000000001
10000000000000000000000000000000000000000000000000000000000000000000000000000001
10000000000000000000000000000000000000000000000000000000000000000000000000000001
10000000000000000000000000000000000000000000000000000000000000000000000000000001
10000000000000000000000000000000000000000000000000000000000000000000000000000001
10000000000000000000000000000000000000000000000000000000099999000000000000000001
10000000000000000000000000000000000000011111111111119100000000000000000000000001
10000000000000000000000000000000000000018888888888688100000000099999000000000001
1x000000000000000000000000000000000000018888888888888100000000000000099990000x51
11100000000000000000000000000000000000018888888888888100000000000000000000999991
11110000000000000000000000000000000000088888888888888100000000000000000009900001
11111000000000000000000000000000000000088888888888888100000000000000000099000001
11111100000000000000000000000000000000088888888888888100000000000000000990000001
11111110000000000000000000000000000007088811111111111100000000000000009900000001
11111111000000000000000000000000000099000000000000000000000000000000099000000001
11111111100000000000000000000000000990000000000000000000000000000000990000000001
11111111110000000000000000000000009900000000000000000000000000000009900000000001
11111111111000000000000000000000099000000000000000000000000000000099000000000001
11111111111100x000000000000x0000000000000000000000000000000000000000000000000001
11111111111133333333333333333333333333333333333333333333333333332222222222222221
11111111111111111111111111111111111111111111111111111111111111111111111111111111
2 10
hmm. . .
weeeee
Jump up there if you want!
finhish!