11111111111111111111111111111111111111111111111111111111111111111111111111111111
11122222222222222222222222222222222222222222222222222222222222222222222222222111
10112222222222222222222222222222222222222222222222222222222222222222222222221101
10011222222222222222222222222222222222222222222222222222222222222222222222211001
10001122222222222222222222222222222222222222222222222222222222222222222222110001
10000112222222222222222222222222222222222222222222222222222222222222222221100001
10000011111111111111111111111111111111111111111111111111111111111111111111000001
10000000000000000000000000000000000000000000000000000000000000000000000000000001
10000000000000000000000000000000000000000000000000000000000000000000000000000001
100000000000040000040000040000040000x0400000400000400000400004000040000000000001
10000000000119999999999999999999999999999999999999999999999999999991000000000001
100000000x1118888888888888888888888888888888888888888888888888888881100000000001
10000000011118888888888888888888888888888888888888888888888888888881110000000001
10000000111118888888888888888888888888888888888888888888888888888881111000000001
10000001111118888888888888888888888888888888888888888888888888888881111100000001
10000011111118888888888888888888888888888888888888888888888888888881111000000001
10000111111118888888888888888888888888888888888888888888888888888881111881000001
10001111111118888888888888888888888888888888888888888888888888888881118811100001
10011111111118888888888888888888888688868886888888888888888888888881188111110001
101111111111188888888888888888888888888888888888888888888888888888818811111110x1
11111111111118888888888887887887887887887887887887887888888888888888811111111151
11111111111111111111111111111111111111111111111111111111111111111111111111111111
2 20
Do you like Simple?
I know you will do that!
Boring~