11111111111111111111111111111111111111111111111111111111111111111111111111111111
10010000010000000000000000000000000000000000000000000000050080000000000000000001
11010000010091999990999900999999909999999999099999909999999180000000000000000001
10010000010081000000000000000000000000000000000000000000000080000000000000000001
10410000011081000000000000000000000000000000000000000000000080000000000000000001
10010000010081000000000000000000000000000000000000000000600080000000000000000001
10010000010081000000000000000000000000000000000000000000060080000000000000000001
14010000010081000000000000000000000000000000000000000000000080000000000000000001
10010000010091000000000000000000000000000000000000000000000080000000000000000001
10010000010081000000000000000000000000000000000000000000000080000000000000000001
10010000011081000000000000000000000000000000000000000000000080000000000000000001
10410000010081000000000000000000000000000000000000000000000000000000000000000001
10010000010081000000000000000000000000000000000000000000000000000000000000000001
10010000010081000000000000000000000000000000000000000000000000000000000000000001
17010000010091000000000000000000000000000000000000000000000000000000000000000001
14010000010081000000000000000000000000000000000000000000000000000000000000000001
10010000011081000000000000000000000000000000000000000000000000000000000000000001
10610000010081000000000000000000000000000000000000000000000000000000000000000001
10411111110081000000000000000018888888100000000000000000000000000000000000000001
10000000000001000000000000000018787878100000000000000000000000000000000000000001
10000000000001444444444444444444444444444444444444444444444444444444444444444441
11111111111111111111111111111111111111111111111111111111111111111111111111111111
2 2
