11111111111111111111111111111111111111111111111111111111111111111111111111111111
111111111111111 11 1 1111111 111 11111111 111 11111111 11111 11 11111 11 1111111
11111111 11111111    111111   111111111 11111111111111111  11111  111 1 1 1111 1
1  1 111  1111 33   111111      1  1 11   1 11  1 11  11   1 1     11 1 11  11 1
1    111  1 1        11  1            1    111                     11   1      1
1     1                                     1                                  1
1                    7                                                         1
1                                                                              1
1                                                                              1
1                    1                                                         1
1                3  11                                                         1
1                1 111                                                         1
1               111111                    13                                   1
1             15111                       11                                   1
1            1111                        113              m                    1
1i         111111l                       13               m                    1
11111111    1114444444444              111                m                    1
1111111      1                         113                m       1  1        91
1111 1       1             111        11113k  13         111     11  111      11
111          1222222222222111111211211111121221121221122111121211112211122112211
11333333333331222222222112111111111111111111221111111111111111111112211121112211
11111111111111111111111111111111111111111111111111111111111111111111111111111111
2
Nothing to say...







