11111111111111111111111111111111111111111111111111111111111111111111111111111111
1i                 33 333333  1 3333 33      11111111111111111111111111111111111
1111416666666661                   m         11     3333331111111111111111111111
111  111111111111            31    m         11 11        3111111111           1
1   11111111111116666666666666666666666      11  11       31 3333331   8       1
13  31111111111111666666666611111111166      111  111    311       3       1  91
13  31111111111111111111111111111111166      1111  111               11111111111
1  511111111111111111111111111111111166 3313 11111  1111111111111111111111111111
13 111111111111111111111111111111111166 1113 111111  111111111111111111111111111
1    1111111111111111111111111111111166 333   111111  11111111111111111111111111
1   73111111111111111111111111111111166       1111111   111111111111111111111111
11    311111111111111111111111111111166   33    1111111          111111111111111
115    31111111111111111111111111111166  3113    111111111111111 111111111111111
1111    3111111111111111111111111111166  31113   j11111111       111111111111111
11111            1111111111111111111166   333  11111111111 111111111111111111111
111111   3 3 3      3111111331133 113663       33111111111       111111111111111
11111111111111113    111113  33    3 6613        311111111111111 111111111111111
1111111111111111111   3333           663                         111111111111111
11111111111111111111            31  k66            3  3 111111111111111111111111
11111111111111111111111666666666666666666666666666611111111111111111111111111111
11111111111111111111111166666666666666666666666661111111111111111111111111111111
11111111111111111111111111111111111111111111111111111111111111111111111111111111
2
Amazing!







