11111111111111111111111111111111111111111111111111111111111111111111111111111111
1                  1111111111111            111111111111111111111111111111111111
1i              111111             111111111111       11111                 11 1
1111   111111111111                         111111111111111     9           1111
1111                        7               111111111111111            m      11
1111111111111                      l        111111111111111            m       1
111111111111    1111111122211222111111111111111111111111111            m       1
111111111111   11111111122222222111111     111    111111111       1    m       1
111111111111   1111111112222222222111111111111 111111111111111122222221111111  1
111111111111   11111111111111111111111111111111111       111111222222211111113 1
1111   11111   11111111      111111111111       11          11111111111111111  1
1      11111                    111111                      11111111111111111  1
1   111111111111             111111      1    1             111111      11111 31
1111111            111111                144441111111                          1
1         111111111111                   1    1111111                          1
1      111111111111111111       111222111122221111111                11111111151
1   111111      111111     33111111111111111111111111                11111111111
1      111111111111111111111111111111133333 111111111222222221111111111111111111
1                                                j  1111111111111111111111111111
1                                           1111111111111      11111111111111111
1151111111  33  1111111111111  8   1151111111111111111111111  1111111111      11
11111111111111111111111111111111111111111111111111111111111111111111111111111111
2
This is what we call a hot end!






