11111111111111111111111111111111111111111111111111111111111111111111111111111111
1i    n  3 33111111111111111111111111111111     11111 11111111111111111111111111
1111111      1111111        1111111111111         133 3333  11111111111111111111
111111111    31113   1    1  331111               19        11111111111111111111
111111111    311    111 3111        111111      11111111111  1111111111111111111
1111111113 3       1111 31111   1111111111111 1111111111111   111111111111111111
1111111111 111111    1    1    11111111111111 11111111111111    1111111111111111
11111111   111111111   3    11111111111111111m11111111111111 3  1111111111111111
11111111 15111111111111111111111113333333 33   3333333333 11111  311111111111111
111 1111 1111111111111111111111111                        111111  11111111111111
11       113333311121111611111111166666666666 6666666666661111    11111111111111
11   11 111     1112211661111111   666666666  6666666666611      111111111111111
111 111 1113333 1111162111111111    666666      6666611111    115111111111111111
111111  1111111  112211661111111  7    66666  8 611111       1111111111111111111
111111 111111111 112111161111111k  11                   1 1 11111111111111111111
111111            111111111111111 1111111 1       1 1111111111111111111111111111
111  1111 1111111 11111111111111111 1111111     1 11111111 111111111111111111111
11            111        1111111 111111441 11  11 11411 111111111111111111111111
11    11111   1111       111111111 1 1 14 1 1  1 1 111 1 11 11111111111111111111
111  111111   111113 3 3j1111111                            11111111111111111111
11111111111333111111111111111111222222222222222222222222222211111111111111111111
11111111111111111111111111111111111111111111111111111111111111111111111111111111
2
This looks like a frozen lake.
WOW! This is very strange.






