11111111111111111111111111111111111111111111111111111111111111111111111111111111
111111111111111111111111111111111111111111111111111111111111111111111111 1111111
1111111111111111111111111111111111 11111111111 1111 111111111 11111 1111  111111
11111 11 11111111111 111111111 11   1111  111   111  1111111  1111   11    11  1
1 111 1   1111111111    1111    1   11111  111       1111111  11111   1    1   1
1  1       111  111             11    11    1         11111    11 1            1
1           1    1                    1               1 11      1              1
1           1                                           11                     1
1                                                                              1
1                                                                             l1
1                                                                           j k1
1                                                                         k k j1
1                                                                       j l j l1
1                                                                     l k j j k1
1                                                                   l j j k j k1
1                                                                 j k j k j k j1
1                                                               l j l k j l k k1
1i                                                            l k k k l j l l j1
11111111111111111111111111111111111111111111111111111111111111111111111111111111
11111111111111111111111111111111111111111111111111111111111111111111111111111111
11111111111111111111111111111111111111111111111111111111111111111111111111111111
11111111111111111111111111111111111111111111111111111111111111111111111111111111
0
