11111111111111111111111111111111111111111111111111111111111111111111111111111111
1                                         1111111111111111111111111111         1
1                            11111111111  111111      1111                     1
1i           1111111444441111111111111    111111111      1                    91
1111111111111111111       111111          111111      1111   1111111111222111111
1111111111111111111       111111          111111111      1  11111111111222111111
1       7                                 1111111111111111 111111111111111111111
1                111222221111111          111111111      1         111       111
1                111222221111111          11111111111111111        111       111
1k     3311111111111111111111111          111111111      1111111   11111  1  111
11111111111111111111111111111111          111111      1111111111   11111  11 1 1
11111111111111111111111111111111111111  11111111111111111111111           11   1
1111111                  3       n        111111111                       1111l1
1111111                    3     n        111111111                   11111111 1
1   111   1111111111111111111111111   8   111111111   111111111115111111111111 1
1111111   111          1111111111111111111111111111   111111111111111111111111 1
1   111                         1111111111      111   1111111111111111113   33 1
1111111   1111111111                    11111          333333   3   3          1
1   111          111111                 11               m    3   3   3        1
1111111222222111111111112221111111111                 16666666166616661666566651
1111222222222222211111111111111111111           11115111111111111111111111111111
11111111111111111111111111111111111111111111111111111111111111111111111111111111
2
No way to go back now!
Ha! Nice try!






